NO         ./textures/tt.xpm
SO ./textures/paint.xpm        
EA        ./textures/rp.xpm

F 33,33,33
WE ./textures/pb.xpm
C 155,206,255


11111111111
10000000001
10000000011
10000000001
10000000001
10000000001
10000000001
10000000001
10000000001
1111100111111111111111111111111
10000000001111111111111111111111111111111
1000N0000000000000000000000000000000011111111111
1000000000111111111111111111111111111111
10000000011
10000000001
10000000001
10000000001
10000000001
10000000001
10000000001
11110011111
11111111111


